Страница 2.
Доступные категории и величины, которые к ним относятся:

Length - длина
Величины:
nm - нанометр, mkm - микрометр, mm - миллиметр, cm - сантиметр, dm - дециметр,
m - метр, km - километр.

Weight - вес
Величины:
mkg - микрограмм, mg - миллиграмм, g - грамм, kg - килограмм, q - центнер,
t - тонна

Speed - скорость
kms - километр в секунду, ms - метр в секунду, kmh - километр в час,
dms - дециметр в секунду, cms - сантиметр в секунду, mh - метр в час,
dmh - дециметр в час, cmh - сантиметр в час

Time - время
ns - наносекунда, mks - микросекунда, ms - миллисекунда, s - секунда,
m - минута, h - час, d - день, w - неделя) 

Area - площадь
mkm^2 - кв. микрометр, mm^2 - кв. миллиметр, cm^2 - кв. сантиметр,
dm^2 - кв. дециметр, m^2 - кв. метр, a - ар, ha - , km^2 - кв. километр

Volume - объём
mm^3 - куб. миллиметр, ml - миллитр, cl - сантилитр, dl - децилитр,
l - литр, hl - гектолитр, m^3 - куб. метр

Datarate - скорость передачи данных
bps - бит в сек. , kbps - кило бит в сек., kB/s - кило байт в сек, 
Mbps - мегабит в сек, MB/s - мегабайт в сек., Gbps - гигабит в сек.,
GB/s - гигабайт в сек., Tbps - терабит в сек., TB/s - терабайт в сек.

Datasize - объём данных
bit - бит, byte - байт, KB - килобайт, MB - мегабайт, GB - гигабайт,
TB - терабайт

